####################
#  ##    # # ##    #
## ##### # # #### ##
#    #     # # #   #
#### #####       ###
###      #######   #
#   #### ###     ###
### #        # #   #
#   # # # # ## ## ##
#################S##