####################
# #  # # #         #
# ## # # ####### ###
#            # #   #
############   # ###
## # #  #    #    ##
#  # ##   ## ## #  #
##      # ######## #
### ## ## #        #
##################S#